Codon	AA	Abs_AA
TTT	Phe	F
TTC	Phe	F
TTA	Leu	L
TTG	Leu	L
CTT	Leu	L
CTC	Leu	L
CTA	Leu	L
CTG	Leu	L
ATT	Ile	I
ATC	Ile	I
ATA	Ile	I
ATG	Met	M
GTT	Val	V
GTC	Val	V
GTA	Val	V
GTG	Val	V
TCT	Ser	S
TCC	Ser	S
TCA	Ser	S
TCG	Ser	S
CCT	Pro	P
CCC	Pro	P
CCA	Pro	P
CCG	Pro	P
ACT	Thr	T
ACC	Thr	T
ACA	Thr	T
ACG	Thr	T
GCT	Ala	A
GCC	Ala	A
GCA	Ala	A
GCG	Ala	A
TAT	Tyr	Y
TAC	Tyr	Y
TAA	Ter	X
TAG	Ter	X
CAT	His	H
CAC	His	H
CAA	Gln	Q
CAG	Gln	Q
AAT	Asn	N
AAC	Asn	N
AAA	Lys	K
AAG	Lys	K
GAT	Asp	D
GAC	Asp	D
GAA	Glu	E
GAG	Glu	E
TGT	Cys	C
TGC	Cys	C
TGA	Ter	X
TGG	Trp	W
CGT	Arg	R
CGC	Arg	R
CGA	Arg	R
CGG	Arg	R
AGT	Ser	S
AGC	Ser	S
AGA	Arg	R
AGG	Arg	R
GGT	Gly	G
GGC	Gly	G
GGA	Gly	G
GGG	Gly	G
